AA = Rickard Stark (M)
AB = Eddard Stark (M)
AC = Catelyn Tully (V)
AD = Brandon Stark (M)
AE = Benjen Stark (M)
AF = Jon Snow (M)
AG = Robb Stark (M)
AH = Sansa Stark (V)
AI = Arya Stark (V)
AJ = Bran Stark (M)
AK = Rickon Stark (M)
AL = Hoster Tully (M)
AM = Minisa Whent (V)
AN = Edmure Tully (M)
AO = Lysa Tully (V)
AP = Jon Arryn (M)
AQ = Robert Arryn (M)
AR = Tytos Lannister (M)
AS = Tywin Lannister (M)
AT = Joanna Lannister (V)
AU = Kevan Lannister (M)
AV = Cersei Lannister (V)
AW = Jamie Lannister (M)
AX = Tyrion Lannister (M)
AY = Robert Baratheon (M)
AZ = Joffrey Baratheon (M)
BA = Myrcella Baratheon (V)
BB = Tommen Baratheon (M)
BC = Lancel Lannister (M)
BD = Steffon Baratheon (M)
BE = Stannis Baratheon (M)
BF = Selyse Florent (V)
BG = Shireen Baratheon (V)
BH = Renly Baratheon (M)
BI = Jaehaerys Targaryen (M)
BJ = Aerys Targaryen (M)
BK = Rhaella Targaryen (V)
BL = Rhaegar Targaryen (M)
BM = Elia Martell (V)
BN = Rhaenys Targaryen (V)
BO = Aegon Targaryen (M)
BP = Viserys Targaryen (M)
BQ = Daenerys Targaryen (V)
BR = Quellon Greyjoy (M)
BS = Balon Greyjoy (M)
BT = Euron Greyjoy (M)
BU = Victarion Greyjoy (M)
BV = Urrigon Greyjoy (M)
BW = Aeron Greyjoy (M)
BX = Rodrik Greyjoy (M)
BY = Maron Greyjoy (M)
BZ = Asha Greyjoy (V)
CA = Theon Greyjoy (M)
CB = Alannys Harlaw (V)
